0 200 300 200 300 100 0 100
150 500 150 800 575 800 575 675 310 675 310 500
760 990 760 660 845 660 845 990
999 180 750 180 750 260 999 260
400 10 400 340 545 340 545 10